000000000000010
011111111111110
010000000000010
010111101111010
010100010000000
010101010101010
010101000101100
010101010001010
000101010100010
010100100001010
010100010001110
010111011101000
010000001011100
011101101101001
000000000001102
